11111111111111xxxxxxxxxxx
10000000P00001xxxxxxxxxxx
10001000000001xxxxxxxxxxx
1000000001001xxxxxx111xxx
100010000100011111xxxx1P1 1111
100000000100010000xxxx111 1001
11111111111111x111xxxxxxx 1101
xxxxxxxxxxxxxxxxxxxxxxxxx
xxx1111xxxxxxxxxxxxxxxxxx