11111111111111
10000000000001
10001000000001
10000000010001
10001000010001
10000000010001
11111111111111